1111111111111
1P1C000000001
1011100000001
1000000000101
100000000C1E1
1111111111111
